institution	country	location	location_abbr
Harvard University	USA	Cambridge	MA
Massachusetts Institute of Technology	USA	Cambridge	MA
Stanford University	USA	Stanford	CA
University of Cambridge	United Kingdom		
California Institute of Technology	USA	Pasadena	CA
Princeton University	USA	Princeton	NJ
University of Oxford	United Kingdom		
Yale University	USA	New Haven	CT
Columbia University	USA	New York	NY
University of California, Berkeley	USA		
University of Chicago	USA	Chicago	IL
Cornell University	USA	Ithaca	NY
University of Pennsylvania	USA	Philadelphia	PA
University of Tokyo	Japan		
Johns Hopkins University	USA	Baltimore	MD
Swiss Federal Institute of Technology in Zurich	Switzerland		
Kyoto University	Japan		
Weizmann Institute of Science	Israel		
University of California, Los Angeles	USA		
University of California, San Diego	USA		
Rockefeller University	USA		
Hebrew University of Jerusalem	Israel		
New York University	USA	New York	NY
University of California, San Francisco	USA		
University of Wisconsin–Madison	USA		
University of Illinois at Urbana–Champaign	USA		
Duke University	USA	Durham	NC
Imperial College London	United Kingdom		
University of Texas Southwestern Medical Center	USA		
University of Texas at Austin	USA		
University College London	United Kingdom		
Osaka University	Japan		
Northwestern University	USA	Evanston	IL
University of Michigan, Ann Arbor	USA		
University of Toronto	Canada		
University of North Carolina at Chapel Hill	USA		
Washington University in St. Louis	USA	St. Louis	MO
University of Utah	USA	Salt Lake City	UT
University of Washington - Seattle	USA		
University of California, Santa Barbara	USA		
McGill University	Canada		
Purdue University, West Lafayette	USA		
Carnegie Mellon University	USA	Pittsburgh	PA
University of Southern California	USA	Los Angeles	CA
University of California, Davis	USA		
University of Colorado Boulder	USA		
University of California, Irvine	USA		
University of Paris-Sud	France		
University of Minnesota, Twin Cities	USA		
University of Arizona	USA	Tucson	AZ
Technion – Israel Institute of Technology	Israel		
Ohio State University, Columbus	USA		
University of Rochester	USA	Rochester	NY
École normale supérieure - Paris	France		
University of Florida	USA	Gainesville	FL
Tel Aviv University	Israel		
Rice University	USA	Houston	TX
Dartmouth College	USA	Hanover	NH
Vanderbilt University	USA	Nashville	TN
University of Edinburgh	United Kingdom		
École Polytechnique	France		
Boston University	USA	Boston	MA
Pierre-and-Marie-Curie University	France		
Pennsylvania State University, University Park	USA		
University of Geneva	Switzerland		
Brown University	USA	Providence	RI
University of British Columbia	Canada		
University of Maryland, College Park	USA		
Swiss Federal Institute of Technology in Lausanne	Switzerland		
Karolinska Institute	Sweden		
University of Pittsburgh - Pittsburgh Campus	USA		
Rutgers University-New Brunswick	USA		
Texas A&M University, College Station	USA		
Nagoya University	Japan		
Seoul National University	South Korea		
University of Manchester	United Kingdom		
Sapienza University of Rome	Italy		
Case Western Reserve University	USA	Cleveland	OH
Tohoku University	Japan		
Arizona State University	USA		
Emory University	USA	Atlanta	GA
Ruprecht Karl University of Heidelberg	Germany		
Ludwig Maximilian University of Munich	Germany		
University of Virginia	USA	Charlottesville	VA
Leiden University	Netherlands		
Tufts University	USA	Medford	MA
Georgia Institute of Technology	USA	Atlanta	GA
University of Zurich	Switzerland		
University of Helsinki	Finland		
Technical University of Munich	Germany		
University of Oslo	Norway		
University of Queensland	Australia		
University of Copenhagen	Denmark		
University of Sydney	Australia		
Williams College	USA		
University of Texas MD Anderson Cancer Center	USA		
University of Nottingham	United Kingdom		
University of Bristol	United Kingdom		
Utrecht University	Netherlands		
Mines ParisTech	France		
Keio University	Japan		
King's College London	United Kingdom		
Indiana University - Bloomington	USA		
National University of Singapore	Singapore		
Stony Brook University	USA		
Lomonosov Moscow State University	Russia		
Australian National University	Australia		
University of Alberta	Canada		
Paris Diderot University - Paris 7	France		
Waseda University	Japan		
Peking University	China		
University of Notre Dame	USA	Notre Dame	IN
National Taiwan University	Taiwan		
Tsinghua University	China		
Kyushu University	Japan		
Katholieke Universiteit Leuven	Belgium		
Tokyo Institute of Technology	Japan		
University of Melbourne	Australia		
University of Bonn	Germany		
Royal Institute of Technology	Sweden		
Erasmus University Rotterdam	Netherlands		
Yonsei University	South Korea		
Michigan State University	USA	East Lansing	MI
University of the Witwatersrand	South Africa		
Lund University	Sweden		
Georgetown University	USA	Washington	DC
Aarhus University	Denmark		
University of Barcelona	Spain		
Baylor College of Medicine	USA		
University of Amsterdam	Netherlands		
Uppsala University	Sweden		
University of Iowa	USA	Iowa City	IA
University of Groningen	Netherlands		
Korea Advanced Institute of Science and Technology (KAIST)	South Korea		
Radboud University Nijmegen	Netherlands		
Korea University	South Korea		
University of São Paulo	Brazil		
University of Colorado Denver	USA		
University of Montreal	Canada		
Albert Ludwig University of Freiburg	Germany		
Ghent University	Belgium		
University of Glasgow	United Kingdom		
University of Miami	USA	Coral Gables	FL
Université libre de Bruxelles	Belgium		
McMaster University	Canada		
University of Birmingham	United Kingdom		
University of Texas at Dallas	USA		
VU University Amsterdam	Netherlands		
Wake Forest University	USA	Winston-Salem	NC
University of Southampton	United Kingdom		
Nanyang Technological University	Singapore		
University of New South Wales	Australia		
Osaka City University	Japan		
University of Leeds	United Kingdom		
Western University (The University of Western Ontario)	Canada		
Kobe University	Japan		
University of Basel	Switzerland		
University of Hong Kong	Hong Kong		
Indiana University-Purdue University Indianapolis	USA		
Humboldt University of Berlin	Germany		
Free University of Berlin	Germany		
University of Tübingen	Germany		
Goethe University Frankfurt	Germany		
University of Houston	USA	Houston	TX
University of California, Santa Cruz	USA		
University of Alabama at Birmingham	USA		
Icahn School of Medicine at Mount Sinai	USA		
University of Calgary	Canada		
University of Gothenburg	Sweden		
University of Göttingen	Germany		
Monash University	Australia		
Southern Methodist University	USA	Dallas	TX
Yeshiva University	USA	New York	NY
University of South Florida - Tampa	USA		
Hanyang University	South Korea		
Oregon Health & Science University	USA		
University of Strasbourg	France		
University of Cincinnati	USA	Cincinnati	OH
University of Sheffield	United Kingdom		
University of Hamburg	Germany		
George Washington University	USA	Washington	DC
University of Milan	Italy		
Iowa State University	USA	Ames	IA
University of Maryland, Baltimore	USA		
University of Padua	Italy		
University of New Mexico	USA	Albuquerque	NM
Pohang University of Science and Technology	South Korea		
Stockholm University	Sweden		
Hokkaido University	Japan		
Fudan University	China		
University of Sussex	United Kingdom		
Université catholique de Louvain	Belgium		
Wayne State University	USA		
University of Massachusetts Medical School	USA		
University of Lausanne	Switzerland		
Shanghai Jiao Tong University	China		
University of Missouri–Columbia	USA		
Technical University of Denmark	Denmark		
Complutense University of Madrid	Spain		
University of Cologne	Germany		
Trinity College, Dublin	Ireland		
University of Bern	Switzerland		
Chinese University of Hong Kong	Hong Kong		
University of Kansas	USA	Lawrence	KS
Sungkyunkwan University	South Korea		
University of Vienna	Austria		
Zhejiang University	China		
University of Georgia	USA	Athens	GA
University of Massachusetts Amherst	USA		
Cardiff University	United Kingdom		
University of Münster	Germany		
University of Liverpool	United Kingdom		
University of Ottawa	Canada		
University of Erlangen-Nuremberg	Germany		
Queen Mary University of London	United Kingdom		
Karlsruhe Institute of Technology	Germany		
Louisiana State University - Baton Rouge	USA		
Nanjing University	China		
University of Illinois at Chicago	USA		
University of Bologna	Italy		
University of Manitoba	Canada		
Joseph Fourier University	France		
University of California, Riverside	USA		
Julius-Maximilian's University of Würzburg	Germany		
Aix-Marseille University	France		
University of Western Australia	Australia		
Laval University	Canada		
University of Tennessee, Knoxville	USA		
North Carolina State University	USA		
Newcastle University	United Kingdom		
Claude Bernard University Lyon 1	France		
University of Turin	Italy		
University of Kiel	Germany		
University of Connecticut	USA	Storrs	CT
Tulane University	USA	New Orleans	LA
University of Oklahoma - Norman Campus	USA		
Brandeis University	USA	Waltham	MA
Dresden University of Technology	Germany		
RWTH Aachen University	Germany		
University of Texas Health Science Center at San Antonio	USA		
Virginia Commonwealth University	USA	Richmond	VA
University of Montpellier 2	France		
Dalian University of Technology	China		
Rensselaer Polytechnic Institute	USA	Troy	NY
Paul Sabatier University - Toulouse III	France		
Paris Descartes University	France		
National Cheng Kung University	Taiwan		
University of Delaware	USA	Newark	DE
Vrije Universiteit Brussel	Belgium		
Johannes Gutenberg University of Mainz	Germany		
Maastricht University	Netherlands		
University of Düsseldorf	Germany		
University of Dundee	United Kingdom		
University of Tsukuba	Japan		
Autonomous University of Barcelona	Spain		
Florida State University	USA	Tallahassee	FL
University of Texas at San Antonio	USA		
London School of Hygiene & Tropical Medicine	United Kingdom		
Lehigh University	USA	Bethlehem	PA
University of Kentucky	USA	Lexington	KY
Thomas Jefferson University	USA		
Drexel University	USA	Philadelphia	PA
Colorado State University - Fort Collins	USA		
University of Leicester	United Kingdom		
Durham University	United Kingdom		
Oregon State University	USA	Corvallis	OR
University of Florence	Italy		
University of Cape Town	South Africa		
University at Buffalo, The State University of New York	USA		
University College Dublin	Ireland		
University of Science and Technology of China	China		
Virginia Polytechnic Institute and State University	USA		
University of Naples Federico II	Italy		
University of Auckland	New Zealand		
University of Texas Health Science Center at Houston	USA		
Delft University of Technology	Netherlands		
University of Aberdeen	United Kingdom		
Queen's University	Canada		
University of Lisbon	Portugal		
Hiroshima University	Japan		
University of Waterloo	Canada		
Okayama University	Japan		
University of Ulm	Germany		
Chulalongkorn University	Thailand		
Dalhousie University	Canada		
Saint Petersburg State University	Russia		
Norwegian University of Science and Technology	Norway		
University of Reading	United Kingdom		
Wageningen University and Research Centre	Netherlands		
Umeå University	Sweden		
University of Porto	Portugal		
Hong Kong University of Science and Technology	Hong Kong		
Sun Yat-sen University	China		
Medical College of Wisconsin	USA		
City College of New York	USA		
Hannover Medical School	Germany		
Washington State University, Pullman	USA		
Technical University of Berlin	Germany		
University of South Carolina - Columbia	USA		
Leipzig University	Germany		
University of Stuttgart	Germany		
University of Valencia	Spain		
Linköping University	Sweden		
University of Duisburg-Essen	Germany		
Ruhr University Bochum	Germany		
University of Bergen	Norway		
London School of Economics	United Kingdom		
Wesleyan University	USA		
University of Pisa	Italy		
Autonomous University of Madrid	Spain		
Medical University of Vienna	Austria		
Stellenbosch University	South Africa		
Medical University of South Carolina	USA		
Charles University in Prague	Czech Republic		
Kyungpook National University	South Korea		
University of Science, Malaysia	Malaysia		
University of Liège	Belgium		
University of Hull	United Kingdom		
Northeastern University	USA	Boston	MA
Kansas State University	USA	Manhattan	KS
University of Vermont	USA	Burlington	VT
Rush University	USA		
University of Louisville	USA	Louisville	KY
University of St Andrews	United Kingdom		
University of Warwick	United Kingdom		
University of Rome Tor Vergata	Italy		
University of Innsbruck	Austria		
Darmstadt University of Technology	Germany		
Indian Institute of Technology Delhi	India		
Federal University of Rio de Janeiro	Brazil		
University of Antwerp	Belgium		
National and Kapodistrian University of Athens	Greece		
Boston College	USA	Chestnut Hill	MA
Vita-Salute San Raffaele University	Italy		
Gwangju Institute of Science and Technology	South Korea		
University of Nebraska–Lincoln	USA		
University of York	United Kingdom		
National Autonomous University of Mexico	Mexico		
University of Regensburg	Germany		
Yokohama National University	Japan		
University of Adelaide	Australia		
University of Genoa	Italy		
Queen's University Belfast	United Kingdom		
University of Marburg	Germany		
University of Pavia	Italy		
St George's, University of London	United Kingdom		
University of Oregon	USA	Eugene	OR
University of Navarra	Spain		
San Diego State University	USA	San Diego	CA
Nankai University	China		
University of East Anglia	United Kingdom		
University of Nebraska Medical Center	USA		
University of Southern Denmark	Denmark		
Eindhoven University of Technology	Netherlands		
Xiamen University	China		
University of Otago	New Zealand		
University of Santiago de Compostela	Spain		
University of Exeter	United Kingdom		
University of Jena	Germany		
University of Perugia	Italy		
Justus Liebig University Giessen	Germany		
College of William and Mary	USA		
Ben-Gurion University of the Negev	Israel		
Saint Louis University	USA	St. Louis	MO
Colorado School of Mines	USA	Golden	CO
Oklahoma State University–Stillwater	USA		
University of Guelph	Canada		
University of Trieste	Italy		
University of Verona	Italy		
University at Albany, SUNY	USA		
Tongji University	China		
Eötvös Loránd University	Hungary		
University of Alabama - Tuscaloosa	USA		
University of Eastern Finland	Finland		
Ewha Womans University	South Korea		
City University of Hong Kong	Hong Kong		
Tokyo Medical and Dental University	Japan		
University of Victoria	Canada		
University of Buenos Aires	Argentina		
University of Texas Medical Branch at Galveston	USA		
Kyung Hee University	South Korea		
Hong Kong Polytechnic University	Hong Kong		
Saarland University	Germany		
Scuola Normale Superiore di Pisa	Italy		
University of Seville	Spain		
Beijing Normal University	China		
Chiba University	Japan		
University of Ferrara	Italy		
University of Bari Aldo Moro	Italy		
Polytechnic University of Milan	Italy		
Temple University	USA	Philadelphia	PA
University of Turku	Finland		
Aalto University	Finland		
Simon Fraser University	Canada		
Tianjin University	China		
Chalmers University of Technology	Sweden		
Middle East Technical University	Turkey		
Cranfield University	United Kingdom		
York University	Canada		
Xi'an Jiaotong University	China		
Chonnam National University	South Korea		
University of Central Florida	USA	Orlando	FL
University of Lorraine	France		
University of Bordeaux II	France		
University of New Hampshire	USA	Durham	NH
Versailles Saint-Quentin-en-Yvelines University	France		
Chonbuk National University	South Korea		
Kumamoto University	Japan		
Huazhong University of Science and Technology	China		
Brunel University	United Kingdom		
Polytechnic University of Catalonia	Spain		
National Chiao Tung University	Taiwan		
Southeast University	China		
Tokyo University of Science	Japan		
Catholic University of the Sacred Heart	Italy		
Brigham Young University	USA		
Technical University of Madrid	Spain		
Nagasaki University	Japan		
National Tsing Hua University	Taiwan		
University of Warsaw	Poland		
King Saud University	Saudi Arabia		
University of Bath	United Kingdom		
Concordia University	Canada		
Georgia Regents University	USA		
Niigata University	Japan		
University of Oulu	Finland		
Pompeu Fabra University	Spain		
Vienna University of Technology	Austria		
Sogang University	South Korea		
Gyeongsang National University	South Korea		
University of Tampere	Finland		
University of Milan - Bicocca	Italy		
University of Bordeaux I	France		
Swedish University of Agricultural Sciences	Sweden		
George Mason University	USA	Fairfax	VA
Jilin University	China		
University of Delhi	India		
University of Campinas	Brazil		
Wuhan University	China		
West Virginia University	USA	Morgantown	WV
Pusan National University	South Korea		
University of Mississippi - Oxford Campus	USA		
University of Arkansas for Medical Sciences	USA		
Miami University	USA		
University of Tokushima	Japan		
University of Twente	Netherlands		
Loyola University Chicago	USA	Chicago	IL
Ajou University	South Korea		
Syracuse University	USA	Syracuse	NY
Lancaster University	United Kingdom		
Pontifical Catholic University of Chile	Chile		
University of Chile	Chile		
Innsbruck Medical University	Austria		
University of Granada	Spain		
Kanazawa University	Japan		
University of Parma	Italy		
University of Siena	Italy		
Shandong University	China		
Technical University of Dortmund	Germany		
University of KwaZulu-Natal	South Africa		
University of Nevada, Reno	USA		
Yokohama City University	Japan		
École normale supérieure de Lyon	France		
University College Cork	Ireland		
Ohio University	USA	Athens	OH
Central South University	China		
University of Modena and Reggio Emilia	Italy		
New Mexico State University	USA	Las Cruces	NM
University of Konstanz	Germany		
University of Hawaii at Manoa	USA		
University of Nebraska Omaha	USA		
Shinshu University	Japan		
University of Strathclyde	United Kingdom		
Baylor University	USA	Waco	TX
Polytechnic University of Valencia	Spain		
Harbin Institute of Technology	China		
University of Rennes 1	France		
University of Arkansas - Fayetteville	USA		
Aristotle University of Thessaloniki	Greece		
Jagiellonian University	Poland		
Texas Tech University (TTU)	USA		
University of Rostock	Germany		
University of Akron	USA		
University of Saskatchewan	Canada		
Juntendo University	Japan		
University of Wyoming	USA	Laramie	WY
Macquarie University	Australia		
University of Canterbury	New Zealand		
University of Denver	USA	Denver	CO
Illinois Institute of Technology	USA	Chicago	IL
Creighton University	USA		
Bielefeld University	Germany		
University of Malaya	Malaysia		
University of Ulsan	South Korea		
City University London	United Kingdom		
Grenoble Institute of Technology	France		
Federal University of Minas Gerais	Brazil		
University of Hanover	Germany		
South China University of Technology	China		
University of Surrey	United Kingdom		
Otto-von-Guericke University Magdeburg	Germany		
Indian Institute of Science	India		
Tokyo Metropolitan University	Japan		
Bar-Ilan University	Israel		
Mississippi State University	USA	Mississippi State	MS
University of Maryland, Baltimore County	USA		
University of Wollongong	Australia		
Flinders University	Australia		
Martin Luther University of Halle-Wittenberg	Germany		
Graduate University for Advanced Studies	Japan		
Clemson University	USA	Clemson	SC
University of Brescia	Italy		
Georgia State University	USA		
Dongguk University	South Korea		
University of Fribourg	Switzerland		
Sichuan University	China		
University of Iceland	Iceland		
University of Sherbrooke	Canada		
University of Graz	Austria		
University of Málaga	Spain		
University of Zaragoza	Spain		
New York Medical College	USA		
SUNY Downstate Medical Center	USA		
École Centrale Paris	France		
Utah State University	USA	Logan	UT
University of Ljubljana	Slovenia		
University of Montpellier 1	France		
Victoria University of Wellington	New Zealand		
East China University of Science and Technology	China		
Konkuk University	South Korea		
University of Potsdam	Germany		
University of the Basque Country	Spain		
University of Nice Sophia Antipolis	France		
University of Udine	Italy		
National Yang-Ming University	Taiwan		
Indian Institute of Technology Bombay	India		
University of Bayreuth	Germany		
University of Wisconsin–Milwaukee	USA		
University of Dayton	USA	Dayton	OH
Nihon University	Japan		
Montana State University - Bozeman	USA		
Royal Holloway, University of London	United Kingdom		
Tokyo Women's Medical University	Japan		
Panjab University	India		
Tampere University of Technology	Finland		
University of Coimbra	Portugal		
University of Newcastle	Australia		
Nara Institute of Science and Technology	Japan		
Auburn University	USA	Auburn	AL
University of Bremen	Germany		
Mahidol University	Thailand		
University of Crete	Greece		
Bangor University	United Kingdom		
University of Aveiro	Portugal		
University of Palermo	Italy		
Nagoya City University	Japan		
University of Tartu	Estonia		
University of Savoy	France		
University of Tromsø - The Arctic University of Norway	Norway		
University of Missouri–Kansas City	USA		
Beihang University	China		
American University of Beirut	Lebanon		
University of Nantes	France		
University of Essex	United Kingdom		
University of Zagreb	Croatia		
National Central University	Taiwan		
University Lille 1: Sciences and Technologies	France		
University of Catania	Italy		
National Polytechnic Institute of Toulouse	France		
Indian Institute of Technology Kanpur	India		
Kagoshima University	Japan		
Lanzhou University	China		
James Cook University	Australia		
Shizuoka University	Japan		
Indian Institute of Technology Kharagpur	India		
Second University of Naples	Italy		
Indian Institute of Technology Madras	India		
Plymouth University	United Kingdom		
International School for Advanced Studies	Italy		
Polytechnic University of Turin	Italy		
University of Oviedo	Spain		
Ehime University	Japan		
University of Ioannina	Greece		
University of Cagliari	Italy		
Tottori University	Japan		
Federal University of Rio Grande do Sul	Brazil		
Kent State University	USA	Kent	OH
University of Los Andes (Colombia)	Colombia		
Hunan University	China		
Tokai University	Japan		
LSU Health Sciences Center New Orleans	USA		
Southern Illinois University Carbondale	USA		
Tata Institute of Fundamental Research	India		
Aalborg University	Denmark		
Osaka Prefecture University	Japan		
Chang Gung University	Taiwan		
Northern Illinois University	USA	DeKalb	IL
University of Trento	Italy		
Semmelweis University	Hungary		
University of Science and Technology Beijing	China		
National University of Ireland, Galway	Ireland		
Dankook University	South Korea		
Istanbul University	Turkey		
Tokyo University of Agriculture and Technology	Japan		
University of Montana - Missoula	USA		
Queensland University of Technology	Australia		
Binghamton University	USA		
Université de Namur	Belgium		
University of Tasmania	Australia		
University of Pretoria	South Africa		
Central China Normal University	China		
Indian Institute of Technology Roorkee	India		
Curtin University	Australia		
Deakin University	Australia		
Tilburg University	Netherlands		
Inha University	South Korea		
University of New Orleans	USA		
Paris-Est Créteil Val-de-Marne University	France		
University of L'Aquila	Italy		
Chungnam National University	South Korea		
University of Salamanca	Spain		
University of Alaska Fairbanks	USA		
University of Poitiers	France		
Albany Medical College	USA		
Birkbeck, University of London	United Kingdom		
Griffith University	Australia		
Federal University of São Paulo	Brazil		
Carleton University	Canada		
Massey University	New Zealand		
Catholic University of Korea	South Korea		
Open University (UK)	United Kingdom		
University of Patras	Greece		
Universidade Nova de Lisboa	Portugal		
Texas A&M Health Science Center	USA		
Braunschweig University of Technology	Germany		
National Chung Hsing University	Taiwan		
La Trobe University	Australia		
Missouri University of Science and Technology	USA		
University of Idaho	USA	Moscow	ID
Louisiana Tech University	USA	Ruston	LA
University of Portsmouth	United Kingdom		
University of La Laguna	Spain		
Florida International University	USA		
Medical University of Graz	Austria		
Howard University	USA	Washington	DC
University of Hertfordshire	United Kingdom		
State University of New York Upstate Medical University	USA		
Royal College of Surgeons in Ireland	Ireland		
National Technical University of Athens	Greece		
University of Windsor	Canada		
Rovira i Virgili University	Spain		
University of Burgundy	France		
Gunma University	Japan		
AGH University of Science and Technology	Poland		
Gifu University	Japan		
Hacettepe University	Turkey		
Örebro University	Sweden		
Memorial University of Newfoundland	Canada		
Kindai University	Japan		
University of Rhode Island	USA	Kingston	RI
University of Alicante	Spain		
New Jersey Institute of Technology	USA	Newark	NJ
Lille 2 University of Health and Law	France		
Keele University	United Kingdom		
University of Jyväskylä	Finland		
Rochester Institute of Technology	USA	Rochester	NY
Sapporo Medical University	Japan		
Banaras Hindu University	India		
King Abdullah University of Science and Technology	Saudi Arabia		
Northeast Normal University	China		
Portland State University	USA		
University of Québec at Montreal	Canada		
East China Normal University	China		
University of Debrecen	Hungary		
Loma Linda University	USA		
Old Dominion University	USA	Norfolk	VA
University of Insubria	Italy		
University of Nevada, Las Vegas	USA		
Hong Kong Baptist University	Hong Kong		
University of Minho	Portugal		
University of Messina	Italy		
University of Texas at Arlington	USA		
University François Rabelais, Tours	France		
UNESP, São Paulo State University	Brazil		
Toho University	Japan		
Beijing University of Chemical Technology	China		
Rutgers, The State University of New Jersey - Newark	USA		
Johannes Kepler University of Linz	Austria		
Warsaw University of Technology	Poland		
University of Paris 13	France		
University of Toyama	Japan		
University of Toledo	USA		
University of Vigo	Spain		
University of Kent	United Kingdom		
Jichi Medical University	Japan		
Roma Tre University	Italy		
Chung Yuan Christian University	Taiwan		
University of Haifa	Israel		
Åbo Akademi University	Finland		
Swansea University	United Kingdom		
China Agricultural University	China		
Marche Polytechnic University	Italy		
University of Maine, Orono	USA		
Heriot-Watt University	United Kingdom		
Marquette University	USA	Milwaukee	WI
Loughborough University	United Kingdom		
Kaiserslautern University of Technology	Germany		
Aston University	United Kingdom		
University of Girona	Spain		
Hasselt University	Belgium		
Nanjing University of Science and Technology	China		
University of Natural Resources and Life Sciences, Vienna	Austria		
University of Szeged	Hungary		
Soochow University (Suzhou)	China		
University of the Balearic Islands	Spain		
Fuzhou University	China		
University of Memphis	USA		
San Francisco State University	USA		
East Carolina University	USA	Greenville	NC
University of Augsburg	Germany		
University of Missouri–St. Louis	USA		
Kyoto Prefectural University of Medicine	Japan		
Shanghai University	China		
University of South Australia	Australia		
Liverpool John Moores University	United Kingdom		
Graz University of Technology	Austria		
Kitasato University	Japan		
University of North Carolina at Charlotte	USA		
G. d'Annunzio University, Chieti-Pescara	Italy		
University of Cantabria	Spain		
Miguel Hernández University of Elche	Spain		
Donghua University	China		
Comenius University in Bratislava	Slovak Republic		
University of Alabama in Huntsville	USA		
Mie University	Japan		
University of Stirling	United Kingdom		
Hunter College	USA		
Swinburne University of Technology	Australia		
University of Ulster	United Kingdom		
University of Évry Val d'Essonne	France		
University of Salerno	Italy		
National University of La Plata	Argentina		
Masaryk University	Czech Republic		
Yamaguchi University	Japan		
University of Yamanashi	Japan		
Showa University	Japan		
North Dakota State University - Main Campus	USA		
University of North Texas, Denton	USA		
University of Mississippi Medical Center	USA		
University of Tehran	Iran		
Paul Valéry University, Montpellier III	France		
Wuhan University of Technology	China		
University of Hyogo	Japan		
The Catholic University of America	USA	Washington	DC
University of Neuchâtel	Switzerland		
National Polytechnic Institute	Mexico		
Jikei University School of Medicine	Japan		
University of Valladolid	Spain		
University of Calabria	Italy		
University of Lübeck	Germany		
Kurume University	Japan		
Peking Union Medical College	China		
Yamagata University	Japan		
University of Córdoba (Spain)	Spain		
University of Mons	Belgium		
Saga University	Japan		
Clarkson University	USA	Potsdam	NY
University of South Alabama	USA		
Inje University	South Korea		
University of Caen Lower Normandy	France		
University of Castilla–La Mancha	Spain		
Czech Technical University in Prague	Czech Republic		
Saitama Medical University	Japan		
Istanbul Technical University	Turkey		
Kaohsiung Medical University	Taiwan		
University of Electro-Communications	Japan		
Yeungnam University	South Korea		
Jawaharlal Nehru Centre for Advanced Scientific Research	India		
Putra University, Malaysia	Malaysia		
Institut national des sciences Appliquées de Lyon	France		
University of Perpignan Via Domitia	France		
University of Miyazaki	Japan		
Second Military Medical University	China		
Northern Arizona University	USA		
École Polytechnique de Montréal	Canada		
University of Salento	Italy		
Fukuoka University	Japan		
Nagoya Institute of Technology	Japan		
Ankara University	Turkey		
Blaise Pascal University	France		
University of Electronic Science and Technology of China	China		
National Sun Yat-sen University	Taiwan		
University of Rouen	France		
Bowling Green State University	USA	Bowling Green	OH
Norwegian University of Life Sciences	Norway		
University of Picardie Jules Verne	France		
Michigan Technological University	USA	Houghton	MI
University of Concepción	Chile		
China Medical University (Taiwan)	Taiwan		
University of Hohenheim	Germany		
Aberystwyth University	United Kingdom		
Wilfrid Laurier University	Canada		
Cairo University	Egypt		
University of Murcia	Spain		
Palacký University, Olomouc	Czech Republic		
Taipei Medical University	Taiwan		
University of Bradford	United Kingdom		
King Fahd University of Petroleum and Minerals	Saudi Arabia		
Ege University	Turkey		
University of Belgrade	Serbia		
"University of Eastern Piedmont Amedeo Avogadro"""""	Italy		
Budapest University of Technology and Economics	Hungary		
University of Salzburg	Austria		
University of Massachusetts Lowell	USA		
Jaume I University	Spain		
Chongqing University	China		
Beijing Institute of Technology	China		
Manchester Metropolitan University	United Kingdom		
Zhengzhou University	China		
Dublin City University	Ireland		
National University of Ireland, Maynooth	Ireland		
Kangwon National University	South Korea		
Royal Veterinary College, University of London	United Kingdom		
Wright State University - Dayton	USA		
Capital Medical University	China		
University of Brighton	United Kingdom		
Sofia University	Bulgaria		
University of Regina	Canada		
Magna Græcia University of Catanzaro	Italy		
Chungbuk National University	South Korea		
Kōchi University	Japan		
University of New Brunswick	Canada		
Sejong University	South Korea		
Sharif University of Technology	Iran		
Chung-Ang University	South Korea		
Queens College, City University of New York	USA		
Murdoch University	Australia		
Chosun University	South Korea		
Vilnius University	Lithuania		
University of Maribor	Slovenia		
Ritsumeikan University	Japan		
University of Sassari	Italy		
Nanjing Normal University	China		
University of Franche-Comté	France		
University of Texas at El Paso	USA		
Rio de Janeiro State University	Brazil		
Jinan University	China		
University of Massachusetts Boston	USA		
University of Alcalá	Spain		
Tehran University of Medical Sciences	Iran		
University of the Ryukyus	Japan		
University of Angers	France		
Fluminense Federal University	Brazil		
Florida Institute of Technology	USA	Melbourne	FL
Trent University	Canada		
National Chung Cheng University	Taiwan		
Bilkent University	Turkey		
National Taiwan Normal University	Taiwan		
Saitama University	Japan		
RMIT University	Australia		
Hamamatsu University School of Medicine	Japan		
University of Greifswald	Germany		
University of Pécs	Hungary		
University of Fukui	Japan		
Oakland University	USA		
Nanjing University of Technology	China		
University of Technology, Sydney	Australia		
University of North Carolina at Greensboro	USA		
All India Institute of Medical Sciences, New Delhi	India		
Kyoto Institute of Technology	Japan		
Ocean University of China	China		
Chiang Mai University	Thailand		
University of Camerino	Italy		
Hirosaki University	Japan		
University of North Dakota	USA	Grand Forks	ND
University of Extremadura	Spain		
Teikyo University	Japan		
Jiangnan University	China		
Adam Mickiewicz University in Poznań	Poland		
University of Waikato	New Zealand		
University of Veterinary Medicine Vienna	Austria		
University of Cádiz	Spain		
Florida Atlantic University	USA		
Huazhong Agricultural University	China		
Brock University	Canada		
University of Lleida	Spain		
Shanghai Normal University	China		
Jean Monnet University	France		
Shimane University	Japan		
University of Orléans	France		
University of Siegen	Germany		
Makerere University	Uganda		
University of Wales, Trinity Saint David	United Kingdom		
National Taiwan University of Science and Technology	Taiwan		
University of Brasília	Brazil		
University of Western Brittany	France		
Nanjing Agricultural University	China		
National University of Córdoba	Argentina		
Federal University of Santa Catarina	Brazil		
National Taiwan Ocean University	Taiwan		
Gazi University	Turkey		
National University of Colombia	Colombia		
University of Jaén	Spain		
Boğaziçi University	Turkey		
Jadavpur University	India		
Pukyong National University	South Korea		
University of Western Sydney	Australia		
Northeastern University (China)	China		
University of Mannheim	Germany		
University of Osnabrück	Germany		
Charles Darwin University	Australia		
University of Hyderabad	India		
Northwest University (China)	China		
University of Southern Mississippi	USA	Hattiesburg	MS
University of Wrocław	Poland		
Carlos III University of Madrid	Spain		
Novosibirsk State University	Russia		
Nanjing Medical University	China		
Nicolaus Copernicus University in Toruń	Poland		
Federal University of Santa Maria	Brazil		
Chemnitz University of Technology	Germany		
Southwest University	China		
Wrocław University of Technology	Poland		
University of California, Merced	USA		
United Arab Emirates University	United Arab Emirates		
Federal University of São Carlos	Brazil		
University of Thessaly	Greece		
University of Basilicata	Italy		
Feng Chia University	Taiwan		
Federal University of Paraná	Brazil		
University of Almería	Spain		
Hallym University	South Korea		
Fourth Military Medical University	China		
University of the Republic (Uruguay)	Uruguay		
Dokuz Eylül University	Turkey		
Nanjing University of Aeronautics and Astronautics	China		
Public University of Navarre	Spain		
University of A Coruña	Spain		
Isfahan University of Technology	Iran		
University of New England (Australia)	Australia		
Federal University of Pernambuco	Brazil		
Jiangsu University	China		
Third Military Medical University	China		
South China Normal University	China		
University of Limerick	Ireland		
Xiangtan University	China		
Yangzhou University	China		
Northwestern Polytechnical University	China		
University of Reims Champagne-Ardenne	France		
Ibaraki University	Japan		
Chung Shan Medical University	Taiwan		
Alexandria University	Egypt		
Yuan Ze University	Taiwan		
University of Cyprus	Cyprus		
University of Silesia	Poland		
Southern Medical University	China		
Shiraz University	Iran		
University of Bucharest	Romania		
Mansoura University	Egypt		
Amirkabir University of Technology	Iran		
Beijing Jiaotong University	China		
University of Valenciennes and Hainaut-Cambresis	France		
University of the Algarve	Portugal		
University of Chemistry and Technology, Prague	Czech Republic		
Federal University of Ceará	Brazil		
Ain Shams University	Egypt		
University of Oldenburg	Germany		
Federal University of Bahia	Brazil		
Hunan Normal University	China		
Western Michigan University	USA	Kalamazoo	MI
University of Seoul	South Korea		
Federico Santa María Technical University	Chile		
Ryerson University	Canada		
South China Agricultural University	China		
Fu Jen Catholic University	Taiwan		
China Pharmaceutical University	China		
Tarbiat Modares University	Iran		
University of Puerto Rico at Mayagüez	Puerto Rico		
National University of Rosario	Argentina		
University of Pau and Pays de l'Adour	France		
Xidian University	China		
Zhejiang University of Technology	China		
China Medical University (PRC)	China		
Federal University of ABC	Brazil		
King Juan Carlos University	Spain		
Beijing University of Technology	China		
Guangxi University	China		
Northwest A&F University	China		
Shanxi University	China		
Tamkang University	Taiwan		
Harbin Medical University	China		
Zhejiang Normal University	China		
King Abdulaziz University	Saudi Arabia		
Iran University of Science and Technology	Iran		
I-Shou University	Taiwan		
University of Maine (Le Mans)	France		
National Dong Hwa University	Taiwan		
National Taipei University of Technology	Taiwan		
Shaanxi Normal University	China		
National University of Defense Technology	China		
Yanbian University	China		
University of Montpellier	France		
Moscow Institute of Physics and Technology	Russia		
University of Bordeaux	France		
University of Oklahoma Health Sciences Center	USA		
Renmin University of China	China		
École normale supérieure de Cachan	France		
National Research Nuclear University MEPhI	Russia		
Jacobs University Bremen	Germany		
École centrale de Lyon	France		
Hefei University of Technology	China		
University of Calcutta	India		
China University of Geosciences (Wuhan)	China		
University of Lethbridge	Canada		
Shahid Beheshti University of Medical Sciences	Iran		
University of Central Lancashire	United Kingdom		
Gachon University	South Korea		
Harbin Engineering University	China		
Ulsan National Institute of Science and Technology	South Korea		
Shenzhen University	China		
Tianjin Medical University	China		
Babeș-Bolyai University	Romania		
Henan Normal University	China		
Southwest Jiaotong University	China		
University of California--Berkeley	USA	Berkeley	CA
University of California--Los Angeles	USA	Los Angeles	CA
University of Michigan--Ann Arbor	USA	Ann Arbor	MI
University of North Carolina--Chapel Hill	USA	Chapel Hill	NC
College of William & Mary	USA	Williamsburg	VA
University of California--Santa Barbara	USA	Santa Barbara	CA
University of California--Irvine	USA	Irvine	CA
University of California--Davis	USA	Davis	CA
University of California--San Diego	USA	La Jolla	CA
University of Illinois--Urbana-Champaign	USA	Champaign	IL
University of Wisconsin--Madison	USA	Madison	WI
Pepperdine University	USA	Malibu	CA
Villanova University	USA	Villanova	PA
Pennsylvania State University--University Park	USA	University Park	PA
Ohio State University--Columbus	USA	Columbus	OH
University of Washington	USA	Seattle	WA
University of Texas--Austin	USA	Austin	TX
Fordham University	USA	New York	NY
Purdue University--West Lafayette	USA	West Lafayette	IN
University of Maryland--College Park	USA	College Park	MD
Worcester Polytechnic Institute	USA	Worcester	MA
Brigham Young University--Provo	USA	Provo	UT
University of Pittsburgh	USA	Pittsburgh	PA
Rutgers University--New Brunswick	USA	Piscataway	NJ
Stevens Institute of Technology	USA	Hoboken	NJ
University of Minnesota--Twin Cities	USA	Minneapolis	MN
American University	USA	Washington	DC
Clark University	USA	Worcester	MA
Texas A&M University--College Station	USA	College Station	TX
University of Massachusetts--Amherst	USA	Amherst	MA
Virginia Tech	USA	Blacksburg	VA
Miami University--Oxford	USA	Oxford	OH
University of California--Santa Cruz	USA	Santa Cruz	CA
Texas Christian University	USA	Fort Worth	TX
Binghamton University--SUNY	USA	Binghamton	NY
Indiana University--Bloomington	USA	Bloomington	IN
University of San Diego	USA	San Diego	CA
University of Tulsa	USA	Tulsa	OK
North Carolina State University--Raleigh	USA	Raleigh	NC
University of Colorado--Boulder	USA	Boulder	CO
Stony Brook University--SUNY	USA	Stony Brook	NY
SUNY College of Environmental Science and Forestry	USA	Syracuse	NY
University at Buffalo--SUNY	USA	Buffalo	NY
University of Alabama	USA	Tuscaloosa	AL
University of Tennessee	USA	Knoxville	TN
University of San Francisco	USA	San Francisco	CA
University of South Carolina	USA	Columbia	SC
University of Missouri	USA	Columbia	MO
University of Nebraska--Lincoln	USA	Lincoln	NE
University of Oklahoma	USA	Norman	OK
University of the Pacific	USA	Stockton	CA
Seton Hall University	USA	South Orange	NJ
University of California--Riverside	USA	Riverside	CA
University of St. Thomas	USA	St. Paul	MN
DePaul University	USA	Chicago	IL
Duquesne University	USA	Pittsburgh	PA
Arizona State University--Tempe	USA	Tempe	AZ
Colorado State University	USA	Fort Collins	CO
New School	USA	New York	NY
Hofstra University	USA	Hempstead	NY
Louisiana State University--Baton Rouge	USA	Baton Rouge	LA
Mercer University	USA	Macon	GA
Rutgers University--Newark	USA	Newark	NJ
University of Arkansas	USA	Fayetteville	AR
University of Mississippi	USA	University	MS
Washington State University	USA	Pullman	WA
Adelphi University	USA	Garden City	NY
St. John Fisher College	USA	Rochester	NY
University at Albany--SUNY	USA	Albany	NY
University of Texas--Dallas	USA	Richardson	TX
Illinois State University	USA	Normal	IL
Immaculata University	USA	Immaculata	PA
Oklahoma State University	USA	Stillwater	OK
University of California--Merced	USA	Merced	CA
University of Illinois--Chicago	USA	Chicago	IL
University of La Verne	USA	La Verne	CA
University of Massachusetts--Lowell	USA	Lowell	MA
Seattle Pacific University	USA	Seattle	WA
University of Alabama--Birmingham	USA	Birmingham	AL
University of Maryland--Baltimore County	USA	Baltimore	MD
University of South Florida	USA	Tampa	FL
Biola University	USA	La Mirada	CA
Maryville University of St. Louis	USA	St Louis	MO
Missouri University of Science & Technology	USA	Rolla	MO
St. John's University	USA	Queens	NY
Union University	USA	Jackson	TN
University of Hawaii--Manoa	USA	Honolulu	HI
Edgewood College	USA	Madison	WI
Ball State University	USA	Muncie	IN
Lipscomb University	USA	Nashville	TN
Montclair State University	USA	Montclair	NJ
Texas Tech University	USA	Lubbock	TX
Andrews University	USA	Berrien Springs	MI
Azusa Pacific University	USA	Azusa	CA
University of Maine	USA	Orono	ME
Widener University	USA	Chester	PA
North Dakota State University	USA	Fargo	ND
Pace University	USA	New York	NY
Robert Morris University	USA	Moon Township	PA
Suffolk University	USA	Boston	MA
University of Hartford	USA	West Hartford	CT
Indiana University-Purdue University--Indianapolis	USA	Indianapolis	IN
Lesley University	USA	Cambridge	MA
University of Alabama--Huntsville	USA	Huntsville	AL
University of Colorado--Denver	USA	Denver	CO
University of Nevada--Reno	USA	Reno	NV
California State University--Fullerton	USA	Fullerton	CA
Central Michigan University	USA	Mount Pleasant	MI
South Dakota State University	USA	Brookings	SD
University of Alaska--Fairbanks	USA	Fairbanks	AK
University of North Carolina--Charlotte	USA	Charlotte	NC
University of South Dakota	USA	Vermillion	SD
Montana State University	USA	Bozeman	MT
University of Missouri--Kansas City	USA	Kansas City	MO
Ashland University	USA	Ashland	OH
Dallas Baptist University	USA	Dallas	TX
Nova Southeastern University	USA	Ft. Lauderdale	FL
Southern Illinois University--Carbondale	USA	Carbondale	IL
University of Montana	USA	Missoula	MT
Benedictine University	USA	Lisle	IL
California State University--Fresno	USA	Fresno	CA
Gardner-Webb University	USA	Boiling Springs	NC
Shenandoah University	USA	Winchester	VA
Tennessee Technological University	USA	Cookeville	TN
University of Massachusetts--Boston	USA	Boston	MA
University of Massachusetts--Dartmouth	USA	North Dartmouth	MA
University of Missouri--St. Louis	USA	St. Louis	MO
University of North Carolina--Greensboro	USA	Greensboro	NC
